Abandon - Động từ - Bỏ rơi, từ bỏ - He abandoned his family. - false
Ability - Danh từ - Khả năng, năng lực - She has a natural ability for music. - false
Abundant - Tính từ - Dồi dào, phong phú - The country is abundant in natural resources. - false
Accept - Động từ - Chấp nhận, nhận - I accept your apology. - false
Access - Danh từ - Tiếp cận, quyền truy cập - We need access to the internet. - false
Accident - Danh từ - Tai nạn, sự cố - It was a terrible accident. - false
Accompany - Động từ - Đi cùng, tháp tùng - He accompanied her to the party. - false
Accomplish - Động từ - Hoàn thành, đạt được - He accomplished his goal. - false
Accurate - Tính từ - Chính xác, đúng đắn - The information is accurate. - false
Achieve - Động từ - Đạt được, thành tựu - She achieved great success in her career. - false
Backpack - Danh từ - Ba lô - He carried his backpack on his back. - false
Bacteria - Danh từ - Vi khuẩn - Bacteria can cause disease. - false
Balance - Danh từ - Sự cân bằng - She lost her balance and fell. - false
Balloon - Danh từ - Bong bóng - The children played with balloons. - false
Banana - Danh từ - Chuối - I like to eat bananas. - false
Band - Danh từ - Nhóm nhạc, ban nhạc - The band played a concert. - false
Bank - Danh từ - Ngân hàng - She went to the bank to deposit money. - false
Barbecue - Danh từ - Tiệc nướng - We had a barbecue in the backyard. - false
Bargain - Danh từ - Món hời, thỏa thuận - He got a bargain on the car. - false
Bark - Danh từ - Vỏ cây - The dog barked at the tree. - false
Calculate - Động từ - Tính toán, suy tính - He calculated the cost of the project. - false
Calendar - Danh từ - Lịch - She marked the date on the calendar. - false
Call - Động từ - Gọi điện, gọi - He called her on the phone. - false
Calm - Tính từ - Bình tĩnh, êm đềm - The sea was calm and peaceful. - false
Camera - Danh từ - Máy ảnh - He took a picture with his camera. - false
Campaign - Danh từ - Chiến dịch - They campaigned for a better environment. - false
Can - Danh từ - Lon, hộp - He opened a can of soup. - false
Cancel - Động từ - Hủy bỏ, thu hồi - He canceled the meeting. - false
Candy - Danh từ - Kẹo - The children love candy. - false
Captain - Danh từ - Thuyền trưởng, đội trưởng - He was the captain of the ship. - false
Danger - Danh từ - Nguy hiểm - It is dangerous to swim in the ocean. - false
Dare - Động từ - Dám, thách thức - I dare you to jump off the cliff. - false
Dark - Tính từ - Tối, đen - It was a dark and stormy night. - false
Daughter - Danh từ - Con gái - She has two daughters. - false
Day - Danh từ - Ngày - Today is a beautiful day. - false
Dead - Tính từ - Chết, đã chết - The animal was dead. - false
Deal - Danh từ - Thỏa thuận, giao dịch - They made a deal. - false
Dear - Tính từ - Quý mến, yêu thương - She is a dear friend. - false
Decision - Danh từ - Quyết định - He made a difficult decision. - false
Deep - Tính từ - Sâu - The ocean is very deep. - false
Earth - Danh từ - Trái đất - We live on Earth. - false
Easy - Tính từ - Dễ dàng - The test was easy. - false
Face - Danh từ - Khuôn mặt, gương mặt - He had a kind face. - false
Factory - Danh từ - Nhà máy - He worked in a factory. - false
Fail - Động từ - Thất bại, không thành công - He failed the test. - false
Fair - Tính từ - Công bằng, hợp lý - It was a fair deal. - false
Fall - Động từ - Rơi, ngã - She fell down the stairs. - false
Family - Danh từ - Gia đình - He has a large family. - false
Famous - Tính từ - Nổi tiếng, danh tiếng - He is a famous actor. - false
Fan - Danh từ - Quạt, người hâm mộ - She is a fan of the band. - false
Fantastic - Tính từ - Tuyệt vời, phi thường - It was a fantastic experience. - false
Far - Tính từ - Xa - The house is far from the city. - false
Fast - Tính từ - Nhanh, tốc độ - He ran fast. - false
Fat - Tính từ - Béo, mập - He is a fat man. - false
Father - Danh từ - Cha, bố - He is a good father. - false
Fear - Danh từ - Nỗi sợ hãi - He was afraid of the dark. - false
Feel - Động từ - Cảm thấy, cảm nhận - She felt happy. - false
Female - Tính từ - Giống cái - She is a female dog. - false
Few - Tính từ - Ít - He has few friends. - false